

Host Name:                      �萢⇒�愡｜褐禮爐致輸菻 荊蓊�狆怦傭从惶冉宜⇒Г輿菖楳詰柱肪徑謡察坦趁甲从材っ徑∵丗 爲莵 耀項畦柱犢腟肪徑爐致輸菻太丗禮
OS Name:                        �萢⇒�从沙�済虐〈 荊莎坿却薈疆倔�б考泰荳考愡｜褐ね曽塲犁傭 肪徑爻埣貎倏傭 爲莵 Windows 11 Pro
OS Version:                      冒丗狹∇罵柱�喉友弛査晒垪儺圈卉 荊荳茹才ゞ屶〈値兒犂桔致諭卉瓠蜆�寤燹坿�藕禮弛査晒垪儺圈卉膏藕 盍逮笈登倏傭讓儿�奏腎爬傭趁冒蒿, 〈短恥沙蜘Щ弛編係埓匸, 肪徑〈秩♂笄済蝓笈勍
OS Manufacturer:               邪藜都桔致夕揄粧温卉从沙�済虐〈 荊菠忠勍疆亟掾澱从沙�済虐〈湛刮号 盍汰僉�奏�萢荊葯紫昂寤遅薑僉疆俥紫香挫拘豬寤礫蕁儿継菁眦 爲莵 Microsoft, Apple, Google, 肪徑 Canonical
OS Configuration:               〈探刮Г菻⇒�从沙�済虐〈 荊葯》菎尿虱А兀敗胡〈歎哥匚疆弌卉暫兀甬茹笈勍 籍黛甲从 爲莵 〈探刮Г菻謡察坦赱登盪秩｜膳寤虐患刮
OS Build Type:                   暫俥牲⇒А卉蔽蚋�从沙�済虐〈 爲莵 Retail (倏傭讓儿犁臍荊荐嗚壕丗継菁篁) 肪徑 OEM (倏傭讓儿荊莎坿却薈倉消虱繊兀爐致萢Ж辧眞Ё匚)   
Registered Owner:              �萢爬蚋⇒Х寤擢経犧嫗 狒怦佑愕虐患刮 Windows, 弛査�巾選怦沃�劬友疆倚粉о紫喉虱匝店實
Registered Organization:      友れ｜荊菘Х俥砕孫 牧，愕虐患刮 Windows 籍黛考Г譟 弛査�巾選怦様Г譟秩登疂冠犹膵∫輿拇衡
Product ID:                        冒丗狹⊆都祇儚煙 礫蜒后卉弛斎倏傭讓儿荊葢顔恥此卉犹坿礫薈匚⇒�从沙�済虐〈
Original Install Date:           廃昂寤虐患刮�从困恥薈畸 弛斎廃昂寤荊 Windows 禽ゝ坿却薈肪徑狠壽巣�б鴻項っ怦友衡
System Boot Time:               倏賭荊菽从材痴菫罫б 肪徑倏賭荊葯っ怦友ね曽塲犁傭貂抖�藕却薈甬葯痴菫犹坿爐致萢
System Manufacturer:          邪藜都誼从 �萢⇒Ъ揄偲垉肪徑畉湛伎⇒Г輿菖楳詰柱 爲莵 HP, Dell, Lenovo
System Model:                    蜘莵⇒�从 弛斎蜘莵⇒Г輿菖楳詰柱 爲莵 Dell XPS 15, HP Envy 17

10. System Type
System Type:                     暫俥牲⇒�从 爲莵 64-bit Operating System 肪徑 32-bit Operating System
Processor(s):                      暫俥牲疆丿唸嚢⇒�壕蚤暫仭播偲 (CPU) 爲莵 Intel Core i7 肪徑 AMD Ryzen 5
BIOS Version:                     倏傭讓儿⇒ BIOS (Basic Input Output System) 荊蓊�禮〈炭抖爐致萢п登で困愾〈探刮Г菻犧怏友級喉友厘柱玩巴
Windows Directory:             脚疔壕Б友眇凍翰柱 Windows 盍損ゝ圜侏泰莊寤 C:\Windows
System Directory:                脚疔壕Б友眇凍翰柱弛査 爲莵 C:\Windows\System32
Boot Device:                        謡察坦豬寤礫蜒后卉細朽っ怦友 爲莵 Hard Drive, USB Drive, CD/DVD Drive
System Locale:                   

  
碩壮籍あ友弛査 爲莵 en-US (籍敏用А追 - 碧恥依狒痴〈) 肪徑 th-TH (籍敏箏 - 暫俥携箏)
Input Locale:                       籍敏⇒п脂江堊場 爲莵 English (United States) 肪徑 Thai (Thailand)
Time Zone:                         皓項播 荊莎刮Б友弛査 爲莵 UTC+7:00 Bangkok, Hanoi, Jakarta
Total Physical Memory:         帽菁造拝賎 RAM 断膳刮�全 禮爐致萢 爲莵 8 GB 肪徑 16 GB
Available Physical Memory:    帽菁造拝賎啖寤片倉旦礫薈匚箚 謀僥�〃寤弛査礫蜆氏悼 爲莵 5.6 GB � 8 GB
Virtual Memory: Max Size:     �甸勉�愆⇒�壕蚤で卅�猜宋郵 荊蓊�狒怦 RAM 冒 爲莵 32 GB
Virtual Memory: Available:     帽菁造拝賎噫柄徑昂寤耐�卅卉吟�б剛顔
Virtual Memory: In Use:        帽菁造拝賎噫柄徑昂寤〉菟с�б考泰
Page File Location(s):            脚疔壕Б友篆東狆 �茹犹膵篆東荊菽从冴�狒怦 RAM 犁臍疆亠虱с�衝藕荊萠卉豐還福讓菁退柄徑項紫 RAM 狆壽


Domain:                              盍狒 荊葯っ怦友ね曽塲犁傭赭�萢禅萢預揶 (禮｜閣荊葯っ怦友預揶禮爐致輸菻騨Г譟)
Logon Server:                       爻埣貎倏傭豬寤礫蜒后卉燿蚋勉菽从 牧÷っ怦友爲怦輿笈諭兀盍狒宏仭姜怦輸友爻埣貎倏傭豬寤罫帽蚋荊莎断�雄∫輿拇〈逐∫卻揶弛査

Link-local IPv6 Address         荊萢泰 IPv6 荊蓊�禮〈段怦擁卉弛貿菻�愡｜褐籍黛項っ徑∵丗第預犂嫗如儿 (篩菠卅卉吟�虐患萢弛貿菻оっ徑∵丗荊葹機笈勍｝剛顔)
IPv4 Address                        荊萢泰 IP 倏傭讓儿 4 �茹犹膵倉誼威昂寤礫蕁儿倉〃寤便眼高邸 盍揃寤預揶 IPv4 �暫弌雄篁顔蚤 4 �刈友却楳鄭 �茹甬菘乖愆奏よ 0-255 疆个刪拘蘿即愆 (.)
Subnet Mask                          却悩茹�蘿菻爐致輸菻詑萢 (subnet) 奏�甸犒菻禊 盍即倔�才’菻荊萢泰 IP ⇒оっ怦友膏藕預揶禮爐致輸菻鯛帽疆俥っ徑∵丗第預篷校弛〕佐蘿 4 �刈友却楳鄭 0-255 爲莵犂嫗如兀 IPv4 Address 盍損ゝ圜倔�遅氏査爲莵 255.255.255.0
Default Gateway                    荊萢泰 IP ⇒�愡｜褐 (爲莵 狠呀詰柱) 荊蓊�篇肪兀〈段茹∫輿拇様＞斬僥爐致輸菻騨怦 (爲莵 耀項畦柱犢腟)
